 ______________________________________________________________________________ 
/..............................................................................\
|..............................................................................|
|..............................................................................|
|..............................................................................|
|..............................................................................|
|..............................................................................|
|..............................................................................|
|..............................................................................|
|..............................................................................|
|..............................................................................|
|..............................................................................|
|..............................................................................|
|..............................................................................|
\............................................................................../
 ‾‾‾‾‾‾‾‾‾‾‾‾‾‾‾‾‾‾‾‾‾‾‾‾‾‾‾‾‾‾‾‾‾‾‾‾‾‾‾‾‾‾‾‾‾‾‾‾‾‾‾‾‾‾‾‾‾‾‾‾‾‾‾‾‾‾‾‾‾‾‾‾‾‾‾‾‾‾ 
