 ______________________________________________________________________________ 
/...|..........................|..........................|....................\
|.........------|..............|..........................|.....................|
|........|......----------------..---------------..--------------..-------------|
|...|....|................................|.............|.......................|
|....----------..---------------------------..-----------.........|.............|
|.......|...........................|.............................|.............|
|....|..|-----------------..........--------------------------------------------|
|....|..|...........|............................|..............................|
|....|---......-----------------------..-----------------------------..---------|
|....|..........................................|...............................|
|....|............|..........---------------------------....--------------------|
|....|............|.............................................................|
|....------------------------------------------------...........................|
\............................................................................../
 ‾‾‾‾‾‾‾‾‾‾‾‾‾‾‾‾‾‾‾‾‾‾‾‾‾‾‾‾‾‾‾‾‾‾‾‾‾‾‾‾‾‾‾‾‾‾‾‾‾‾‾‾‾‾‾‾‾‾‾‾‾‾‾‾‾‾‾‾‾‾‾‾‾‾‾‾‾‾ 
