##########
#..#.....#
#..#..#..#
#.....#..#
#.....#..#
##########