 ________ 
/..|.....\
|..|.....|
|..|..|..|
|.....|..|
\.....|../
 ‾‾‾‾‾‾‾‾ 