ßXß player (mark P =)
ßOß endpoint (mark E =)
ß*ß fog mark (F =)
ß[+,|,-]ß wall marks (WALL =)
ß ß player trail mark (TRAIL =)
ß1ß player reveal zone range (REVEAL =)
+--+--+--+--+--+--+--+--+--+--+--+--+--+--+--+--+--+--+--+--+--+--+--+--+--+--+--+--+--+--+--+--+--+--+--+--+--+--+--+--+--+--+--+--+--+--+--+
|X |  |           |     |           |           |  |     |     |     |     |  |     |    O|              |     |           |                 |
+  +  +  +--+--+  +  +  +  +--+--+  +  +--+--+  +  +  +  +  +  +--+  +--+  +  +  +  +  +--+  +--+  +--+--+  +  +--+--+--+  +  +  +--+--+--+  +
|  |     |        |  |           |     |        |     |  |  |           |  |     |  |     |  |     |        |  |        |     |  |           |
+  +--+--+  +--+--+  +--+--+--+--+--+--+  +--+--+--+--+  +--+--+--+  +  +  +--+--+  +--+  +  +  +--+  +--+--+  +  +  +--+--+--+  +  +--+--+--+
|  |        |     |  |           |        |     |        |        |  |  |        |        |  |        |     |     |        |     |  |     |  |
+  +--+  +--+  +  +  +  +--+--+  +  +--+--+  +--+  +  +--+  +  +--+  +  +  +--+  +--+--+  +  +--+--+--+  +  +--+--+--+--+  +  +--+  +  +  +  +
|     |        |     |  |     |     |              |     |  |  |     |     |  |  |        |     |     |  |  |        |  |     |        |     |
+--+  +  +--+--+  +--+  +  +  +--+--+  +--+  +--+--+--+  +  +  +  +--+--+--+  +  +  +--+--+--+  +  +  +  +  +  +--+  +  +--+--+  +  +--+--+  +
|     |  |     |     |     |  |     |  |     |           |  |     |        |  |              |  |  |     |     |  |     |        |  |        |
+  +--+  +  +--+  +  +--+--+  +--+  +  +  +  +  +--+--+--+  +--+--+--+--+  +  +--+--+--+  +  +  +  +--+--+--+--+  +  +  +--+--+--+  +  +--+--+
|  |  |  |        |        |     |  |  |  |  |  |        |  |  |     |                    |  |  |     |        |  |  |              |     |  |
+  +  +  +--+  +--+--+--+--+--+  +  +  +--+  +  +--+  +--+  +  +  +  +  +--+  +--+--+--+--+  +  +--+  +  +--+  +  +--+--+--+--+--+--+  +  +  +
|  |     |     |     |        |  |  |  |     |        |     |  |  |     |     |     |     |     |     |  |     |     |  |           |  |     |
+  +  +--+  +--+  +  +  +--+--+  +  +--+  +--+--+--+--+  +--+  +  +--+--+  +--+  +  +  +--+--+--+  +--+  +  +--+--+  +  +  +--+--+  +  +--+--+
|  |     |     |  |  |     |     |     |                 |  |     |     |     |  |  |        |     |     |  |        |  |  |     |  |     |  |
+  +--+  +--+  +  +--+  +--+  +--+--+  +--+--+--+  +--+--+  +--+--+  +--+--+  +  +  +--+--+  +  +  +  +--+  +  +--+--+  +  +  +--+  +--+  +  +
|           |  |     |     |        |           |           |     |  |        |  |        |  |  |  |  |     |  |     |     |     |           |
+--+--+  +--+  +--+  +  +  +--+  +  +  +--+--+  +--+--+--+  +  +  +  +  +--+--+  +--+--+  +  +  +  +  +  +--+  +  +  +--+--+--+  +--+--+--+--+
|        |     |        |     |  |  |     |              |  |  |     |  |     |  |     |  |  |  |     |        |  |           |        |     |
+  +--+--+  +--+--+--+--+--+  +  +  +--+  +--+--+--+--+  +  +  +  +  +  +  +--+  +  +  +  +  +  +--+--+--+  +--+  +--+--+--+  +--+--+  +  +  +
|     |     |              |     |  |              |     |  |  |  |  |  |        |  |  |  |  |     |     |        |        |     |        |  |
+--+  +  +--+  +--+--+--+  +--+--+  +  +--+  +--+  +--+--+  +  +--+  +  +--+--+--+  +  +  +  +--+--+  +  +--+--+--+  +--+  +--+  +--+  +  +  +
|     |     |           |        |  |     |  |  |        |  |  |     |        |     |  |  |     |     |  |     |     |        |     |  |  |  |
+  +--+--+  +--+--+--+  +--+  +--+  +--+--+  +  +--+--+  +  +  +  +--+--+--+  +  +--+  +  +--+  +  +--+  +  +  +  +--+--+--+  +--+  +--+  +--+
|  |     |  |        |     |        |     |     |     |  |  |  |     |     |     |     |  |     |  |     |  |  |  |        |     |     |     |
+  +  +  +  +  +--+  +--+--+  +--+--+  +  +--+--+  +  +  +  +  +--+  +  +  +  +--+  +--+  +  +--+  +  +--+  +  +  +  +--+--+--+  +--+  +--+  +
|  |  |  |  |     |  |        |     |  |  |        |     |  |     |  |  |  |  |     |           |  |        |     |  |     |        |     |  |
+--+  +--+  +--+  +  +  +--+--+  +  +--+  +--+--+--+--+  +  +--+--+  +  +  +  +  +--+  +  +--+--+  +--+--+  +--+--+  +  +  +--+  +  +--+  +  +
|     |     |     |           |  |  |                       |        |  |  |  |     |  |  |        |        |     |     |     |  |  |     |  |
+  +  +  +--+  +--+--+  +--+  +  +--+  +  +--+--+--+--+--+--+--+  +--+  +--+  +--+--+  +  +  +--+--+  +--+--+  +  +--+--+--+  +--+  +  +--+  +
|  |     |           |     |           |                          |                    |     |                 |           |        |         
+--+--+--+--+--+--+--+--+--+--+--+--+--+--+--+--+--+--+--+--+--+--+--+--+--+--+--+--+--+--+--+--+--+--+--+--+--+--+--+--+--+--+--+--+--+--+--+
